~~~~~~<(░)>~
────────K──┐
           │
A──┐ ┌───┐ │
   ╔─╝   ╚─┘
B──┘ └┐ ┌┘  
      ╔─╗   
C─────┘ └──┐
 ════════──┘